20 20
100 100
2 2 2 2 2 2 2 2 2 2 2 2 2 2 2 2 2 2 2 2
2 1 0 0 0 0 0 0 0 0 0 0 0 0 0 0 0 0 1 2
2 1 0 2 2 2 2 1 1 1 0 0 0 0 0 0 0 0 1 2
2 4 0 0 0 0 0 0 0 0 0 0 0 0 0 0 0 0 1 2
2 1 0 0 1 1 1 1 1 0 0 0 0 0 0 0 0 0 1 2
2 1 0 0 2 2 2 2 1 0 0 0 0 0 0 0 0 0 1 2
2 1 0 0 0 0 0 0 0 0 0 0 0 0 0 0 0 0 1 2
2 1 0 0 2 2 2 2 1 2 0 0 0 0 0 0 0 0 1 2
2 1 0 0 0 0 0 2 0 2 0 0 0 0 0 0 0 0 1 2
2 1 0 0 0 0 0 2 1 1 0 0 0 0 0 0 0 0 1 2
2 1 0 0 0 4 3 2 0 2 0 0 0 0 2 2 2 2 2 2
2 1 0 4 0 0 3 3 0 0 0 0 0 0 2 1 1 1 1 2
2 1 4 4 0 4 0 3 0 0 0 0 0 0 1 1 1 1 1 2
2 1 4 0 0 0 0 3 0 0 0 0 0 0 2 1 1 1 1 2
2 1 4 0 3 3 3 3 3 0 0 0 0 0 2 2 2 2 2 2
2 1 0 0 0 3 3 3 0 0 0 0 0 0 0 0 0 0 1 2
2 1 0 0 0 3 3 0 0 0 0 0 0 0 0 0 0 0 1 2
2 1 0 0 0 3 0 0 0 0 0 0 0 0 0 0 0 0 1 2
2 1 0 0 0 0 0 0 0 0 0 0 0 0 0 0 0 0 1 2
2 2 2 2 2 2 2 2 2 2 2 2 2 2 2 2 2 2 2 2